###############B#############################################
##.....########.#......................................#...##
##.###.#........####################################.#.#.#.##
##.###.#.#########..........#########.......########.#.#.#.##
##.#####...........########.#.......#.#####.########.#.#.#.##
##.########################.#.#####.#.#...#.########.#.#.#.##
##............................#####.#.##.##.########.#.#.#.##
##.###.############################.#.##.##.########.#.#.#.##
##.###.##...#...#...#...#...#.......#.##.##.########.#.#.#.##
##.###....#...#...#...#...#...#######.##.##.########.#.#.#.##
##.##################################.##.##.########.#.#.#.##
##.......................................##.########.#.#.#.##
###########################################.########.#.#.#.##
###...............................#########..........#.#.#.##
########################.###########################.#.#.#.##
#........................#...........................#.#.#.##
#.######################.#############################.#.#.##
#.#..........#.........................................#.#.##
#.#.########.#.#########################################.#.##
#.#........#.#.#.........................................#.##
#.##########.#.#.#########################################.##
#............#.#.##........................................##
##############.#.#############################.#####.########
#..............................................#####........#
########################A####################################
